NO    			textures/wall_no.xpm   			
SO textures/wall_so.xpm
WE textures/wall_we.xpm
EA textures/wall_ea.xpm

C 35, 19,2              
F 15,6   ,4


111111111111111
111111000111111
111110000011111
111100000001111
111000000000111
110000000000011
100001111100N01 11111
110000111000011111101
111000010000111 11111
111100000001111
111110000011111
111111000111111
111111111111111


