NO textures/wall_no.xpm
SO textures/wall_so.xpm
WE textures/wall_we.xpm
EA textures/wall_ea.xpm
F 184,113,1
C 51,198,227

1111111
11S1111
1111111
