
NO textures/wall_no.xpm
SO textures/wall_so.xpm
WE textures/wall_we.xpm
EA textures/wall_ea.xpm
F 168,230,29
C 90,200,250 

111111111111111111
1000000000000111
10000100010001111           
10010000010001              
1000000S011111              
10000000000001
10000111000001
10000100000001111
111111111111111101
111111111111111111
1111111111111111111110